2,2,2,2,1,1,1,1,1
2,4,3,2,1,1,1,1,1
2,4,0,0,0,1,1,1,1
2,2,4,2,2,1,1,1,1
0,0,0,4,0,0,0,0,0
1,1,2,2,4,4,2,2,1
1,1,0,0,0,0,4,2,1
1,1,1,1,1,2,2,4,1
1,1,1,1,1,1,1,1,1
