0,20,20,20,10,10,10,10,10
20,40,30,20,10,10,10,10,10
20,40,0,0,0,10,10,10,10
20,20,40,20,20,10,10,10,10
0,0,0,40,0,0,0,0,0
10,10,20,20,40,40,20,20,10
10,10,0,0,0,0,40,20,10
10,10,10,10,10,20,20,40,10
10,10,10,10,10,10,10,10,10
