2,2,2,2,2,1,1,1,1
2,4,3,3,2,1,1,1,1
2,4,3,3,2,2,1,1,1
2,4,3,3,3,2,1,1,1
2,4,0,0,0,0,0,1,1
2,2,4,4,4,1,1,1,1
1,2,2,2,2,1,1,1,1
1,1,1,1,1,1,1,1,1
1,1,1,1,1,1,1,1,1
