o,-,o,o,o,o,_,_,_
o,o,-,_,_,o,o,o,_
o,o,-,_,_,_,_,o,_
o,-,x,x,x,x,x,o,_
o,o,-,-,-,_,_,_,_
_,o,o,o,o,_,_,_,_
_,_,_,_,_,_,_,_,_
_,_,_,_,_,_,_,_,_